OOOOOOOOOOOOOOOO
O8  OO     OO OO
OOO OO OOO OO OO
OOO OO OO     OO
OOO    OOOOOO OO
OOOOOO     OO  E
OOOOOOOOOOOOOOOO