OOOOOOOOOOOOOOOOOOOOOOOOOOOOOOOOOOOO
O8  OOOOOOOOOOOOOOOO             OOO
OOO OOOO                OOOOOOOO OOO
OOO      OOOOOOOOOOOOOO      OOO   O
OOO OOOO           OOOO OOO  OOOOO O
OOO OOOOOOOOOOOOO OOO   OOO    OOO O
OOO            OO OOO OOOOOOOO OO  O
OOO OOOOOOOOOO OO OOO OOOO     OO OO
OOO       OOOO OO OOOOOOOO OOOO   OO
OOOO OOOO    OOOO      OOO OOOO  OOO
OOOO OOOOOO         OO OOO   OOO   O
OOOOOOOOOOOOOOOOOOOOOOOOOOOOOOOOEOOO