OOOOOOOOOOOOOOOOOOOOOOOOOOOOOOOOOOOO
O8  OOOOOOOOOOOOOOOO OO          OOO
OOO OOOO        OO      OOOOOOOO OOO
OOO      OOOOO  OOOOOOO            O
OOO         OO           OOOO      O
OOO OOO OO OOO OO OOO    OO    OOO O
OOO            OO  OOOOOOOO OOO    O
OOOOOOOO OOO OO       O   OO   OOO O
OOO       OO O OO OOOO  O  OO     OO
OOOOOOOO     OOOO      OOO OO O  OOO
OOOOOOOOOO         OOO OOO    OO   O
OOOOOOOOOOOOOOOOOOOOOOOOOOOOOOOOEOOO